GameConstValue = {

    --scene name
    NameSceneLoadingScene = "LoadingScene",

    --chapter path pre
    NameChapterQiBingPath = "Assets/Resources/Demo/Character/Battle/lvbu/c_bm_lvbu_lv01_am.prefab",--骑兵
    NameChapterShadeTarget = "c_bm_lvbu_lv01_am",--投影目标
    NameChapterQiBingEffectPath = "Assets/Resources/Effect/Character/Prefab/e_rec_common_guidecircle.prefab", --骑兵特效
    NameChapterQiBingShderPath = "Assets/Resources/Demo/Character/Show/qibing/FullMapCharacterProjector.prefab", --骑兵阴影
    --embattle path
    NameEmbattleGroundPath = "Assets/Resources/Demo/Prefabs/LineUpGround.prefab",
    NameEmbattleGroundDefaultState = "Assets/Resources/UI/Prefabs/BuZhen/pic_buzhen_default.prefab",
    NameEmbattleGroundSelectState = "Assets/Resources/UI/Prefabs/BuZhen/pic_buzhen_select.prefab",
    NameEmbattleGroundCanState = "Assets/Resources/UI/Prefabs/BuZhen/pic_buzhen_can_battle.prefab",
    NameEmbattleGroundNotState = "Assets/Resources/UI/Prefabs/BuZhen/pic_buzhen_ban.prefab",
    NameEmbattleHeroInfoPath = "Assets/Resources/UI/Prefabs/Panel/newHeroInfo.prefab",
    NameEmbattleHeroInfoParentPath = "Assets/Resources/UI/Prefabs/Panel/heroInfo_parent.prefab",
    --item icon path pre
    IconImagePrePath = "Assets/Resources/UI/Images/icon/%s.png",
    IconHeroPrePath = "Assets/Resources/UI/Images/icon/%s.png",

    --panel
    NameUILoadingPanelPath = "Assets/Resources/UI/Prefabs/Panel/loading_panel.prefab",                  --加载界面
    NameUIChapterPanelPath = "Assets/Resources/UI/Prefabs/Panel/chapterdetail_panel.prefab",            --章节列表
    NameUILoginPanelPath = "Assets/Resources/UI/Prefabs/Panel/login_panel.prefab",                      --登录
    NameUIMainPanelPath = "Assets/Resources/UI/Prefabs/Panel/main_panel.prefab",                        --主界面
    NameUIPackagePanelPath = "Assets/Resources/UI/Prefabs/Panel/package_panel.prefab",
    NameUICongratulationPanelPath = "Assets/Resources/UI/Prefabs/Panel/congratulations_panel.prefab",
    NameUIConfirmPanelPath = "Assets/Resources/UI/Prefabs/Panel/confirm_panel.prefab", 
    NameUIStorePanelPath = "Assets/Resources/UI/Prefabs/Panel/store_panel.prefab", 
    NameUICommonBuyPanelPath = "Assets/Resources/UI/Prefabs/Panel/commonBuy_panel.prefab", 
    
    NameUIMailPanelPath = "Assets/Resources/UI/Prefabs/Panel/mail_panel.prefab",                
    NameUIBatchPanelPath = "Assets/Resources/UI/Prefabs/Panel/batch_panel.prefab",                      --批量道具
    NameUICompoundPanelPath = "Assets/Resources/UI/Prefabs/Panel/compound_panel.prefab",                --合成道具
    NameUISelectreWardPanelPath = "Assets/Resources/UI/Prefabs/Panel/selectreward_panel.prefab",        --多选道具
    NameUIGeneralPanelPath = "Assets/Resources/UI/Prefabs/Panel/general_panel.prefab",                  --武将列表
    NameUIGeneralStrengthenPanelPath = "Assets/Resources/UI/Prefabs/Panel/general_levelup_panel.prefab",--武将强化
    NameUIGeneralTrainPanelPath = "Assets/Resources/UI/Prefabs/Panel/generaltrain_panel.prefab",        --武将训练
    NameUIGeneralInfoPanelPath = "Assets/Resources/UI/Prefabs/Panel/generalinfo_panel.prefab",          --武将详情
    NameUISkillTipsPath = "Assets/Resources/UI/Prefabs/Panel/skill_tips.prefab",                        --技能描述tips

    NameUIGeneralPreviewPanelPath = "Assets/Resources/UI/Prefabs/Panel/general_preview.prefab",                   --武将预览
    NameUIGeneralPositionDetailsPanelPath = "Assets/Resources/UI/Prefabs/Panel/general_guanzhi_preview.prefab",   --武将官职预览详情
    NameUIGeneralUpStarPreviewPath = "Assets/Resources/UI/Prefabs/Panel/general_starlevel_preview.prefab",        --武将升星预览
    NameUIGeneralUpstarSuccessPath = "Assets/Resources/UI/Prefabs/Panel/general_upstar_success.prefab",           --武将升星成功

    NameUIEmbattlePanelPath = "Assets/Resources/UI/Prefabs/Panel/embattle_panel.prefab",                --布阵
}
